0 0 0 0 0 0 0 0 0 0 0 0 0 0 0 0 1 2 3 4 0 0 0 0 0 0 0 0 0 0 1 2 3 4 0 0 0 0 0 0 0 0 5 6 0 0 0 0 0 0 0 0 0 0 0 0 0 0 1 2 3 4 0 0 0 0 0 0 0 0 0 0 0 0 5 6 0 0 0 0 0 0 0 0 1 2 3 4 0 0 0 0 0 0 0 0 0 0 1 2 3 4 0 0 0 0 0 0 0 0 0 0 0 0 0 0 0 0 0 0 0 0 0 0 0 0 0 0 1 2 3 4 0 0 0 0 0 0 5 6 0 0 0 0 0 0 0 0 0 0 0 0 0 0 0 0 0 0 0 0 0 0 0 0 0 0 0 0 0 0 0 0 0 0 1 2 3 4 0 0 0 0 0 0 0 0 5 6 0 0 7 8 
0 0 0 0 0 0 0 0 0 0 0 0 0 0 0 0 9 10 11 12 0 0 0 0 0 0 0 0 0 0 9 10 11 12 0 0 0 0 0 0 0 0 13 14 0 0 0 0 0 0 0 0 0 0 0 0 0 0 9 10 11 12 0 0 0 0 0 0 0 0 0 0 0 0 13 14 0 0 0 0 0 0 0 0 9 10 11 12 0 0 0 0 0 0 0 0 0 0 9 10 11 12 0 0 0 0 0 0 0 0 0 0 15 3 0 0 0 0 0 0 0 0 0 0 0 0 0 0 9 10 11 12 0 0 0 0 0 0 13 14 0 0 0 0 0 0 0 0 0 0 15 3 0 0 0 0 0 0 0 0 0 0 0 0 0 0 0 0 0 0 0 0 0 0 9 10 11 12 0 0 0 0 0 0 0 0 13 14 0 0 7 16 
0 0 0 0 0 0 0 0 5 6 0 0 0 0 0 0 0 0 0 0 0 0 5 6 0 0 0 0 0 0 0 0 0 0 0 0 17 18 18 18 18 18 18 18 18 19 0 0 0 0 0 0 0 0 5 6 0 0 0 0 0 0 0 0 0 0 0 0 20 18 18 18 18 19 0 0 17 18 18 18 18 19 0 0 0 0 0 0 0 0 0 0 5 6 21 22 0 0 0 0 17 18 18 18 18 18 18 18 18 19 0 0 1 2 3 4 0 0 20 18 18 19 0 0 0 0 0 0 0 0 0 0 0 0 0 0 0 0 0 0 0 0 0 0 0 0 0 0 0 0 1 2 3 4 0 0 0 0 0 0 0 0 0 0 1 2 3 4 0 0 0 0 0 0 0 0 0 0 0 0 0 0 0 0 0 0 0 0 0 0 7 8 
0 0 15 3 0 0 0 0 13 14 0 0 0 0 0 0 0 0 0 0 0 0 13 14 0 0 0 0 0 0 0 0 0 0 0 0 7 23 23 24 23 24 23 24 23 25 0 0 15 3 0 0 0 0 13 14 0 0 0 0 0 0 0 0 0 0 0 0 26 24 23 24 23 25 0 0 7 23 23 24 23 27 0 0 0 0 0 0 0 0 0 0 13 14 0 0 0 0 0 0 7 23 23 24 23 24 23 24 23 25 0 0 9 10 11 12 0 0 26 24 23 25 0 0 0 0 0 0 0 0 0 0 0 0 0 0 0 0 0 0 0 0 15 3 0 0 0 0 0 0 9 10 11 12 0 0 0 0 0 0 0 0 0 0 9 10 11 12 0 0 0 0 0 0 0 0 0 0 0 0 0 0 15 3 0 0 0 0 0 0 7 16 
0 0 1 2 3 4 0 0 0 0 0 0 0 0 0 0 0 0 0 0 0 0 0 0 0 0 17 18 18 18 18 18 18 18 18 18 28 8 16 8 16 8 16 8 16 27 0 0 1 2 3 4 0 0 0 0 0 0 17 19 0 0 5 6 0 0 29 30 26 8 16 8 16 27 0 0 7 8 16 8 16 27 31 18 18 18 18 18 18 18 18 18 18 18 18 18 18 18 18 18 28 8 16 8 16 8 16 8 16 27 0 0 0 0 0 0 29 30 26 8 16 27 0 0 0 0 0 0 0 0 0 0 0 0 17 18 18 18 18 19 0 0 1 2 3 4 0 0 0 0 0 0 0 0 0 0 0 0 5 6 0 0 0 0 0 0 0 0 0 0 17 18 18 18 18 18 18 18 18 19 0 0 1 2 3 4 0 0 0 0 7 8 
0 0 9 10 11 12 0 0 0 0 0 0 15 3 0 0 0 0 0 0 0 0 0 0 0 0 7 23 23 24 23 24 23 24 23 24 8 16 8 16 8 16 8 16 8 27 0 0 9 10 11 12 0 0 0 0 0 0 7 25 0 0 13 14 0 0 0 0 26 16 8 16 8 27 0 0 7 16 8 16 8 16 23 24 23 24 23 24 23 24 23 24 23 24 23 24 23 24 23 24 8 16 8 16 8 16 8 16 8 27 0 0 0 0 0 0 0 0 26 16 8 27 0 0 0 0 0 0 0 0 0 0 0 0 7 23 23 24 23 25 0 0 9 10 11 12 0 0 0 0 0 0 0 0 0 0 0 0 13 14 0 0 0 0 0 0 0 0 0 0 7 23 23 24 23 24 23 24 23 25 0 0 9 10 11 12 0 0 0 0 32 16 
0 0 0 0 0 0 0 0 0 0 0 0 1 2 3 4 17 18 18 18 18 18 18 18 18 18 28 8 16 8 16 8 16 8 16 8 16 8 16 8 16 8 16 8 16 27 0 0 0 0 0 0 0 0 17 19 0 0 7 27 0 0 0 0 0 0 0 0 26 8 16 8 16 8 0 0 16 8 16 8 33 18 18 34 16 8 16 8 16 8 16 8 33 18 18 34 16 8 16 8 16 8 16 8 16 8 16 8 16 35 13 14 36 37 13 14 13 14 26 8 16 27 13 14 17 19 36 37 17 18 18 18 18 18 28 8 16 8 16 27 0 0 0 0 0 0 17 18 18 19 0 0 0 0 0 0 17 18 18 18 18 19 0 0 0 0 17 18 18 18 28 8 16 8 16 8 16 8 16 27 0 0 0 0 0 0 0 0 0 0 38 7 
0 0 0 0 0 0 0 0 0 0 0 0 9 10 11 12 7 23 23 24 23 24 23 24 23 24 8 16 8 16 8 16 8 16 8 16 8 16 8 16 8 16 8 16 8 27 0 0 0 0 0 0 0 0 7 25 0 0 7 27 0 0 0 0 0 0 0 0 39 16 8 16 8 16 0 0 8 16 8 16 40 41 41 41 8 16 8 16 8 16 8 16 40 41 41 41 8 16 8 16 8 16 8 16 8 16 8 16 42 43 43 43 44 45 43 43 43 43 26 16 8 27 43 43 7 25 44 45 7 23 23 24 23 24 8 16 8 16 8 27 0 0 0 0 0 0 7 23 23 27 0 0 0 0 0 0 7 23 23 24 23 27 0 0 0 0 7 23 23 24 8 16 8 16 8 16 8 16 8 27 0 0 0 0 0 0 0 0 0 0 38 7 
18 18 18 18 18 18 18 18 18 18 18 18 18 18 18 18 28 8 16 8 16 8 16 8 16 8 16 8 16 8 16 8 16 8 16 8 16 8 16 8 16 8 16 8 16 27 36 37 13 14 17 19 13 14 7 27 13 14 7 8 31 18 18 18 18 18 18 18 28 8 16 8 33 18 18 18 18 34 16 8 16 8 16 8 16 8 33 18 18 34 16 8 16 8 16 8 16 8 33 18 18 18 18 18 18 34 16 27 46 47 46 47 46 47 17 19 46 47 26 8 16 27 46 47 7 27 46 47 7 8 16 8 16 8 16 8 16 8 16 27 31 18 18 18 18 18 28 8 16 27 31 18 18 18 18 18 28 8 16 8 16 27 31 18 18 18 28 8 16 8 16 8 16 8 16 8 16 8 16 27 36 37 13 14 17 18 18 18 18 18 48 7 
23 24 23 24 23 24 23 24 23 24 23 24 23 24 23 24 8 16 8 16 8 16 8 16 8 16 8 16 8 16 8 16 8 16 8 16 8 16 8 16 8 16 8 16 8 27 44 45 43 43 7 25 43 43 7 27 43 43 7 16 23 24 23 24 23 24 23 24 8 16 8 16 40 41 41 41 41 41 8 16 8 16 8 16 8 16 40 41 41 41 8 16 8 16 8 16 8 16 40 41 41 41 41 41 41 41 8 27 49 49 49 49 49 49 7 25 49 49 39 16 8 27 49 49 7 27 49 49 7 16 8 16 8 16 8 16 8 16 8 16 23 24 23 24 23 24 8 16 8 16 23 24 23 24 23 24 8 16 8 16 8 16 23 24 23 24 8 16 8 16 8 16 8 16 8 16 8 16 8 27 44 45 43 43 7 23 23 24 23 24 41 16 
16 8 16 8 16 8 16 8 16 8 16 8 16 8 16 8 16 8 16 8 16 8 16 8 16 8 16 8 16 8 16 8 16 8 16 8 16 8 16 8 16 8 16 8 16 27 46 47 46 47 7 27 46 47 7 27 46 47 7 8 16 8 16 8 16 8 16 8 16 8 16 8 16 8 16 8 16 8 16 8 16 8 16 8 16 8 16 8 16 8 16 8 16 8 16 8 16 8 16 8 16 8 16 8 16 8 16 27 50 50 50 50 50 50 7 27 50 50 7 8 16 27 50 50 7 27 50 50 7 8 16 8 16 8 16 8 16 8 16 8 16 8 16 8 16 8 16 8 16 8 16 8 16 8 16 8 16 8 16 8 16 8 16 8 16 8 16 8 16 8 16 8 16 8 16 8 16 8 16 27 46 47 46 47 7 8 16 8 16 8 16 8 
