cellID left top right bottom <objs list>
0 0 0 189 175 1 600 1200
1 190 0 379 175 1 600 500 501 502 503 1000
2 380 0 569 175 1 500 501 502 503 1001 1400
3 570 0 759 175 2 3 4 800 801 1002 1003 1400
4 760 0 949 175 5 6 7 602 603 200 1004 1005 1400
5 950 0 1139 175 7 8 9 602 603 802 1400
6 1140 0 1329 175 9 10 11 601 201 504 1006 1007 1008
7 1330 0 1519 175 9 10 12 13 14 601 504 505 506 1009 1401
8 1520 0 1709 175 14 15 16 506 803 804 1009 1401
9 1710 0 1899 175 17 18 803 804 805 507 1010 1401
10 1900 0 2048 175 18 805 507 508 1300