cellID left top right bottom <objs list>
0 0 0 189 175 0 1 1200
1 190 0 379 175 1 2 500 501 1100 1400
2 380 0 569 175 2 500 501 700 3 1101 1400
3 570 0 759 175 701 3 4 1102 1400
4 760 0 949 175 502 800 5 6 7 1400
5 950 0 1139 175 200 7 8 9 11 100 1103 1400
6 1140 0 1329 175 10 11 12 13 16 201 503 504 801 802 302 1104 1400
7 1330 0 1519 175 13 14 15 16 702 801 802 302 1105 1400
8 1520 0 1709 175 15 16 17 18 801 802 300 301 302 1106 1107 1400
9 1710 0 1899 175 17 19 20 21 505 300 301 101 1108 1400
10 1900 0 2089 175 21 22 23 505 703 1109 1400
11 2090 0 2279 175 23 24 25 703 803 1110 1400
12 2280 0 2469 175 25 26 27 704 803 1111 1400
13 2470 0 2659 175 27 28 29 30 705 804 1112 1113 1400
14 2660 0 2849 175 30 31 600 706 804 1114 1400
15 2850 0 3039 175 31 32 506 600 805 1400
16 3040 0 3072 175 32 506 1300